bool	GetBoolean	bit	Bit
Boolean	GetBoolean	bit	Bit
byte	GetByte	tinyint	TinyInt
Byte	GetByte	tinyint	TinyInt
sbyte	GetByte:(sbyte)	tinyint	TinyInt
SByte	GetByte:(SByte)	tinyint	TinyInt
char	GetChar	char	NChar
Char	GetChar	char	NChar
decimal	GetDecimal	decimal	Money
Decimal	GetDecimal	decimal	Money
double	GetDouble	decimal	Decimal
Double	GetDouble	decimal	Decimal
float	GetFloat	real	Real
Single	GetFloat	real	Real
int	GetInt32	int	Int
Int32	GetInt32	int	Int
uint	GetInt32:(uint)	int	Int
UInt32	GetInt32:(UInt32)	int	Int
long	GetInt64	bigint	BigInt
Int64	GetInt64	bigint	BigInt
ulong	GetInt64:(ulong)	bigint	BigInt
UInt64	GetInt64:(UInt64)	bigint	BigInt
object	GetValue	ntext	NText
Object	GetValue	ntext	NText
short	GetInt16	smallint	SmallInt
Int16	GetInt16	smallint	SmallInt
ushort	GetInt16:(ushort)	smallint	SmallInt
UInt16	GetInt16:(UIn16)	smallint	SmallInt
string	GetString	nvarchar	NVarChar
String	GetString	nvarchar	NVarChar
DateTime	GetDateTime	datetime	DateTime